Month,Date,Beginning Balance,Payment,Principal,Interest,PMI/MIP,Total Payment,Ending Balance
1,2024-01-31,300000.0,1847.15,284.65,1562.5,0.0,1847.15,299715.35
2,2024-03-01,299715.35,1847.15,286.13,1561.02,0.0,1847.15,299429.22
3,2024-03-31,299429.22,1847.15,287.62,1559.53,0.0,1847.15,299141.6
4,2024-04-30,299141.6,1847.15,289.12,1558.03,0.0,1847.15,298852.48
5,2024-05-30,298852.48,1847.15,290.63,1556.52,0.0,1847.15,298561.85
6,2024-06-29,298561.85,1847.15,292.14,1555.01,0.0,1847.15,298269.71
7,2024-07-29,298269.71,1847.15,293.66,1553.49,0.0,1847.15,297976.05
8,2024-08-28,297976.05,1847.15,295.19,1551.96,0.0,1847.15,297680.86
9,2024-09-27,297680.86,1847.15,296.73,1550.42,0.0,1847.15,297384.13
10,2024-10-27,297384.13,1847.15,298.27,1548.88,0.0,1847.15,297085.86
11,2024-11-26,297085.86,1847.15,299.83,1547.32,0.0,1847.15,296786.03
12,2024-12-26,296786.03,1847.15,301.39,1545.76,0.0,1847.15,296484.64
13,2025-01-25,296484.64,1847.15,302.96,1544.19,0.0,1847.15,296181.68
14,2025-02-24,296181.68,1847.15,304.54,1542.61,0.0,1847.15,295877.14
15,2025-03-26,295877.14,1847.15,306.12,1541.03,0.0,1847.15,295571.02
16,2025-04-25,295571.02,1847.15,307.72,1539.43,0.0,1847.15,295263.3
17,2025-05-25,295263.3,1847.15,309.32,1537.83,0.0,1847.15,294953.98
18,2025-06-24,294953.98,1847.15,310.93,1536.22,0.0,1847.15,294643.05
19,2025-07-24,294643.05,1847.15,312.55,1534.6,0.0,1847.15,294330.5
20,2025-08-23,294330.5,1847.15,314.18,1532.97,0.0,1847.15,294016.32
21,2025-09-22,294016.32,1847.15,315.81,1531.34,0.0,1847.15,293700.51
22,2025-10-22,293700.51,1847.15,317.46,1529.69,0.0,1847.15,293383.05
23,2025-11-21,293383.05,1847.15,319.11,1528.04,0.0,1847.15,293063.94
24,2025-12-21,293063.94,1847.15,320.78,1526.37,0.0,1847.15,292743.16
25,2026-01-20,292743.16,1847.15,322.45,1524.7,0.0,1847.15,292420.71
26,2026-02-19,292420.71,1847.15,324.13,1523.02,0.0,1847.15,292096.58
27,2026-03-21,292096.58,1847.15,325.81,1521.34,0.0,1847.15,291770.77
28,2026-04-20,291770.77,1847.15,327.51,1519.64,0.0,1847.15,291443.26
29,2026-05-20,291443.26,1847.15,329.22,1517.93,0.0,1847.15,291114.04
30,2026-06-19,291114.04,1847.15,330.93,1516.22,0.0,1847.15,290783.11
31,2026-07-19,290783.11,1847.15,332.65,1514.5,0.0,1847.15,290450.46
32,2026-08-18,290450.46,1847.15,334.39,1512.76,0.0,1847.15,290116.07
33,2026-09-17,290116.07,1847.15,336.13,1511.02,0.0,1847.15,289779.94
34,2026-10-17,289779.94,1847.15,337.88,1509.27,0.0,1847.15,289442.06
35,2026-11-16,289442.06,1847.15,339.64,1507.51,0.0,1847.15,289102.42
36,2026-12-16,289102.42,1847.15,341.41,1505.74,0.0,1847.15,288761.01
37,2027-01-15,288761.01,1847.15,343.19,1503.96,0.0,1847.15,288417.82
38,2027-02-14,288417.82,1847.15,344.97,1502.18,0.0,1847.15,288072.85
39,2027-03-16,288072.85,1847.15,346.77,1500.38,0.0,1847.15,287726.08
40,2027-04-15,287726.08,1847.15,348.58,1498.57,0.0,1847.15,287377.5
41,2027-05-15,287377.5,1847.15,350.39,1496.76,0.0,1847.15,287027.11
42,2027-06-14,287027.11,1847.15,352.22,1494.93,0.0,1847.15,286674.89
43,2027-07-14,286674.89,1847.15,354.05,1493.1,0.0,1847.15,286320.84
44,2027-08-13,286320.84,1847.15,355.9,1491.25,0.0,1847.15,285964.94
45,2027-09-12,285964.94,1847.15,357.75,1489.4,0.0,1847.15,285607.19
46,2027-10-12,285607.19,1847.15,359.61,1487.54,0.0,1847.15,285247.58
47,2027-11-11,285247.58,1847.15,361.49,1485.66,0.0,1847.15,284886.09
48,2027-12-11,284886.09,1847.15,363.37,1483.78,0.0,1847.15,284522.72
49,2028-01-10,284522.72,1847.15,365.26,1481.89,0.0,1847.15,284157.46
50,2028-02-09,284157.46,1847.15,367.16,1479.99,0.0,1847.15,283790.3
51,2028-03-10,283790.3,1847.15,369.08,1478.07,0.0,1847.15,283421.22
52,2028-04-09,283421.22,1847.15,371.0,1476.15,0.0,1847.15,283050.22
53,2028-05-09,283050.22,1847.15,372.93,1474.22,0.0,1847.15,282677.29
54,2028-06-08,282677.29,1847.15,374.87,1472.28,0.0,1847.15,282302.42
55,2028-07-08,282302.42,1847.15,376.82,1470.33,0.0,1847.15,281925.6
56,2028-08-07,281925.6,1847.15,378.79,1468.36,0.0,1847.15,281546.81
57,2028-09-06,281546.81,1847.15,380.76,1466.39,0.0,1847.15,281166.05
58,2028-10-06,281166.05,1847.15,382.74,1464.41,0.0,1847.15,280783.31
59,2028-11-05,280783.31,1847.15,384.74,1462.41,0.0,1847.15,280398.57
60,2028-12-05,280398.57,1847.15,386.74,1460.41,0.0,1847.15,280011.83
61,2029-01-04,280011.83,1847.15,388.76,1458.39,0.0,1847.15,279623.07
62,2029-02-03,279623.07,1847.15,390.78,1456.37,0.0,1847.15,279232.29
63,2029-03-05,279232.29,1847.15,392.82,1454.33,0.0,1847.15,278839.47
64,2029-04-04,278839.47,1847.15,394.86,1452.29,0.0,1847.15,278444.61
65,2029-05-04,278444.61,1847.15,396.92,1450.23,0.0,1847.15,278047.69
66,2029-06-03,278047.69,1847.15,398.98,1448.17,0.0,1847.15,277648.71
67,2029-07-03,277648.71,1847.15,401.06,1446.09,0.0,1847.15,277247.65
68,2029-08-02,277247.65,1847.15,403.15,1444.0,0.0,1847.15,276844.5
69,2029-09-01,276844.5,1847.15,405.25,1441.9,0.0,1847.15,276439.25
70,2029-10-01,276439.25,1847.15,407.36,1439.79,0.0,1847.15,276031.89
71,2029-10-31,276031.89,1847.15,409.48,1437.67,0.0,1847.15,275622.41
72,2029-11-30,275622.41,1847.15,411.62,1435.53,0.0,1847.15,275210.79
73,2029-12-30,275210.79,1847.15,413.76,1433.39,0.0,1847.15,274797.03
74,2030-01-29,274797.03,1847.15,415.92,1431.23,0.0,1847.15,274381.11
75,2030-02-28,274381.11,1847.15,418.08,1429.07,0.0,1847.15,273963.03
76,2030-03-30,273963.03,1847.15,420.26,1426.89,0.0,1847.15,273542.77
77,2030-04-29,273542.77,1847.15,422.45,1424.7,0.0,1847.15,273120.32
78,2030-05-29,273120.32,1847.15,424.65,1422.5,0.0,1847.15,272695.67
79,2030-06-28,272695.67,1847.15,426.86,1420.29,0.0,1847.15,272268.81
80,2030-07-28,272268.81,1847.15,429.08,1418.07,0.0,1847.15,271839.73
81,2030-08-27,271839.73,1847.15,431.32,1415.83,0.0,1847.15,271408.41
82,2030-09-26,271408.41,1847.15,433.56,1413.59,0.0,1847.15,270974.85
83,2030-10-26,270974.85,1847.15,435.82,1411.33,0.0,1847.15,270539.03
84,2030-11-25,270539.03,1847.15,438.09,1409.06,0.0,1847.15,270100.94
85,2030-12-25,270100.94,1847.15,440.37,1406.78,0.0,1847.15,269660.57
86,2031-01-24,269660.57,1847.15,442.67,1404.48,0.0,1847.15,269217.9
87,2031-02-23,269217.9,1847.15,444.97,1402.18,0.0,1847.15,268772.93
88,2031-03-25,268772.93,1847.15,447.29,1399.86,0.0,1847.15,268325.64
89,2031-04-24,268325.64,1847.15,449.62,1397.53,0.0,1847.15,267876.02
90,2031-05-24,267876.02,1847.15,451.96,1395.19,0.0,1847.15,267424.06
91,2031-06-23,267424.06,1847.15,454.32,1392.83,0.0,1847.15,266969.74
92,2031-07-23,266969.74,1847.15,456.68,1390.47,0.0,1847.15,266513.06
93,2031-08-22,266513.06,1847.15,459.06,1388.09,0.0,1847.15,266054.0
94,2031-09-21,266054.0,1847.15,461.45,1385.7,0.0,1847.15,265592.55
95,2031-10-21,265592.55,1847.15,463.86,1383.29,0.0,1847.15,265128.69
96,2031-11-20,265128.69,1847.15,466.27,1380.88,0.0,1847.15,264662.42
97,2031-12-20,264662.42,1847.15,468.7,1378.45,0.0,1847.15,264193.72
98,2032-01-19,264193.72,1847.15,471.14,1376.01,0.0,1847.15,263722.58
99,2032-02-18,263722.58,1847.15,473.59,1373.56,0.0,1847.15,263248.99
100,2032-03-19,263248.99,1847.15,476.06,1371.09,0.0,1847.15,262772.93
101,2032-04-18,262772.93,1847.15,478.54,1368.61,0.0,1847.15,262294.39
102,2032-05-18,262294.39,1847.15,481.03,1366.12,0.0,1847.15,261813.36
103,2032-06-17,261813.36,1847.15,483.54,1363.61,0.0,1847.15,261329.82
104,2032-07-17,261329.82,1847.15,486.06,1361.09,0.0,1847.15,260843.76
105,2032-08-16,260843.76,1847.15,488.59,1358.56,0.0,1847.15,260355.17
106,2032-09-15,260355.17,1847.15,491.13,1356.02,0.0,1847.15,259864.04
107,2032-10-15,259864.04,1847.15,493.69,1353.46,0.0,1847.15,259370.35
108,2032-11-14,259370.35,1847.15,496.26,1350.89,0.0,1847.15,258874.09
109,2032-12-14,258874.09,1847.15,498.85,1348.3,0.0,1847.15,258375.24
110,2033-01-13,258375.24,1847.15,501.45,1345.7,0.0,1847.15,257873.79
111,2033-02-12,257873.79,1847.15,504.06,1343.09,0.0,1847.15,257369.73
112,2033-03-14,257369.73,1847.15,506.68,1340.47,0.0,1847.15,256863.05
113,2033-04-13,256863.05,1847.15,509.32,1337.83,0.0,1847.15,256353.73
114,2033-05-13,256353.73,1847.15,511.97,1335.18,0.0,1847.15,255841.76
115,2033-06-12,255841.76,1847.15,514.64,1332.51,0.0,1847.15,255327.12
116,2033-07-12,255327.12,1847.15,517.32,1329.83,0.0,1847.15,254809.8
117,2033-08-11,254809.8,1847.15,520.02,1327.13,0.0,1847.15,254289.78
118,2033-09-10,254289.78,1847.15,522.72,1324.43,0.0,1847.15,253767.06
119,2033-10-10,253767.06,1847.15,525.45,1321.7,0.0,1847.15,253241.61
120,2033-11-09,253241.61,1847.15,528.18,1318.97,0.0,1847.15,252713.43
121,2033-12-09,252713.43,1847.15,530.93,1316.22,0.0,1847.15,252182.5
122,2034-01-08,252182.5,1847.15,533.7,1313.45,0.0,1847.15,251648.8
123,2034-02-07,251648.8,1847.15,536.48,1310.67,0.0,1847.15,251112.32
124,2034-03-09,251112.32,1847.15,539.27,1307.88,0.0,1847.15,250573.05
125,2034-04-08,250573.05,1847.15,542.08,1305.07,0.0,1847.15,250030.97
126,2034-05-08,250030.97,1847.15,544.91,1302.24,0.0,1847.15,249486.06
127,2034-06-07,249486.06,1847.15,547.74,1299.41,0.0,1847.15,248938.32
128,2034-07-07,248938.32,1847.15,550.6,1296.55,0.0,1847.15,248387.72
129,2034-08-06,248387.72,1847.15,553.46,1293.69,0.0,1847.15,247834.26
130,2034-09-05,247834.26,1847.15,556.35,1290.8,0.0,1847.15,247277.91
131,2034-10-05,247277.91,1847.15,559.24,1287.91,0.0,1847.15,246718.67
132,2034-11-04,246718.67,1847.15,562.16,1284.99,0.0,1847.15,246156.51
133,2034-12-04,246156.51,1847.15,565.08,1282.07,0.0,1847.15,245591.43
134,2035-01-03,245591.43,1847.15,568.03,1279.12,0.0,1847.15,245023.4
135,2035-02-02,245023.4,1847.15,570.99,1276.16,0.0,1847.15,244452.41
136,2035-03-04,244452.41,1847.15,573.96,1273.19,0.0,1847.15,243878.45
137,2035-04-03,243878.45,1847.15,576.95,1270.2,0.0,1847.15,243301.5
138,2035-05-03,243301.5,1847.15,579.95,1267.2,0.0,1847.15,242721.55
139,2035-06-02,242721.55,1847.15,582.98,1264.17,0.0,1847.15,242138.57
140,2035-07-02,242138.57,1847.15,586.01,1261.14,0.0,1847.15,241552.56
141,2035-08-01,241552.56,1847.15,589.06,1258.09,0.0,1847.15,240963.5
142,2035-08-31,240963.5,1847.15,592.13,1255.02,0.0,1847.15,240371.37
143,2035-09-30,240371.37,1847.15,595.22,1251.93,0.0,1847.15,239776.15
144,2035-10-30,239776.15,1847.15,598.32,1248.83,0.0,1847.15,239177.83
145,2035-11-29,239177.83,1847.15,601.43,1245.72,0.0,1847.15,238576.4
146,2035-12-29,238576.4,1847.15,604.56,1242.59,0.0,1847.15,237971.84
147,2036-01-28,237971.84,1847.15,607.71,1239.44,0.0,1847.15,237364.13
148,2036-02-27,237364.13,1847.15,610.88,1236.27,0.0,1847.15,236753.25
149,2036-03-28,236753.25,1847.15,614.06,1233.09,0.0,1847.15,236139.19
150,2036-04-27,236139.19,1847.15,617.26,1229.89,0.0,1847.15,235521.93
151,2036-05-27,235521.93,1847.15,620.47,1226.68,0.0,1847.15,234901.46
152,2036-06-26,234901.46,1847.15,623.7,1223.45,0.0,1847.15,234277.76
153,2036-07-26,234277.76,1847.15,626.95,1220.2,0.0,1847.15,233650.81
154,2036-08-25,233650.81,1847.15,630.22,1216.93,0.0,1847.15,233020.59
155,2036-09-24,233020.59,1847.16,633.51,1213.65,0.0,1847.16,232387.08
156,2036-10-24,232387.08,1847.15,636.8,1210.35,0.0,1847.15,231750.28
157,2036-11-23,231750.28,1847.16,640.13,1207.03,0.0,1847.16,231110.15
158,2036-12-23,231110.15,1847.15,643.45,1203.7,0.0,1847.15,230466.7
159,2037-01-22,230466.7,1847.16,646.81,1200.35,0.0,1847.16,229819.89
160,2037-02-21,229819.89,1847.15,650.17,1196.98,0.0,1847.15,229169.72
161,2037-03-23,229169.72,1847.16,653.57,1193.59,0.0,1847.16,228516.15
162,2037-04-22,228516.15,1847.15,656.96,1190.19,0.0,1847.15,227859.19
163,2037-05-22,227859.19,1847.16,660.39,1186.77,0.0,1847.16,227198.8
164,2037-06-21,227198.8,1847.16,663.83,1183.33,0.0,1847.16,226534.97
165,2037-07-21,226534.97,1847.16,667.29,1179.87,0.0,1847.16,225867.68
166,2037-08-20,225867.68,1847.15,670.76,1176.39,0.0,1847.15,225196.92
167,2037-09-19,225196.92,1847.15,674.25,1172.9,0.0,1847.15,224522.67
168,2037-10-19,224522.67,1847.16,677.77,1169.39,0.0,1847.16,223844.9
169,2037-11-18,223844.9,1847.15,681.29,1165.86,0.0,1847.15,223163.61
170,2037-12-18,223163.61,1847.16,684.85,1162.31,0.0,1847.16,222478.76
171,2038-01-17,222478.76,1847.15,688.41,1158.74,0.0,1847.15,221790.35
172,2038-02-16,221790.35,1847.15,691.99,1155.16,0.0,1847.15,221098.36
173,2038-03-18,221098.36,1847.16,695.61,1151.55,0.0,1847.16,220402.75
174,2038-04-17,220402.75,1847.15,699.22,1147.93,0.0,1847.15,219703.53
175,2038-05-17,219703.53,1847.16,702.87,1144.29,0.0,1847.16,219000.66
176,2038-06-16,219000.66,1847.15,706.52,1140.63,0.0,1847.15,218294.14
177,2038-07-16,218294.14,1847.16,710.21,1136.95,0.0,1847.16,217583.93
178,2038-08-15,217583.93,1847.15,713.9,1133.25,0.0,1847.15,216870.03
179,2038-09-14,216870.03,1847.16,717.63,1129.53,0.0,1847.16,216152.4
180,2038-10-14,216152.4,1847.15,721.36,1125.79,0.0,1847.15,215431.04
181,2038-11-13,215431.04,1847.15,725.11,1122.04,0.0,1847.15,214705.93
182,2038-12-13,214705.93,1847.16,728.9,1118.26,0.0,1847.16,213977.03
183,2039-01-12,213977.03,1847.16,732.7,1114.46,0.0,1847.16,213244.33
184,2039-02-11,213244.33,1847.15,736.5,1110.65,0.0,1847.15,212507.83
185,2039-03-13,212507.83,1847.16,740.35,1106.81,0.0,1847.16,211767.48
186,2039-04-12,211767.48,1847.15,744.19,1102.96,0.0,1847.15,211023.29
187,2039-05-12,211023.29,1847.16,748.08,1099.08,0.0,1847.16,210275.21
188,2039-06-11,210275.21,1847.16,751.98,1095.18,0.0,1847.16,209523.23
189,2039-07-11,209523.23,1847.15,755.88,1091.27,0.0,1847.15,208767.35
190,2039-08-10,208767.35,1847.15,759.82,1087.33,0.0,1847.15,208007.53
191,2039-09-09,208007.53,1847.16,763.79,1083.37,0.0,1847.16,207243.74
192,2039-10-09,207243.74,1847.15,767.76,1079.39,0.0,1847.15,206475.98
193,2039-11-08,206475.98,1847.15,771.75,1075.4,0.0,1847.15,205704.23
194,2039-12-08,205704.23,1847.16,775.78,1071.38,0.0,1847.16,204928.45
195,2040-01-07,204928.45,1847.16,779.82,1067.34,0.0,1847.16,204148.63
196,2040-02-06,204148.63,1847.16,783.89,1063.27,0.0,1847.16,203364.74
197,2040-03-07,203364.74,1847.15,787.96,1059.19,0.0,1847.15,202576.78
198,2040-04-06,202576.78,1847.15,792.06,1055.09,0.0,1847.15,201784.72
199,2040-05-06,201784.72,1847.16,796.2,1050.96,0.0,1847.16,200988.52
200,2040-06-05,200988.52,1847.16,800.34,1046.82,0.0,1847.16,200188.18
201,2040-07-05,200188.18,1847.16,804.51,1042.65,0.0,1847.16,199383.67
202,2040-08-04,199383.67,1847.15,808.69,1038.46,0.0,1847.15,198574.98
203,2040-09-03,198574.98,1847.16,812.92,1034.24,0.0,1847.16,197762.06
204,2040-10-03,197762.06,1847.15,817.14,1030.01,0.0,1847.15,196944.92
205,2040-11-02,196944.92,1847.16,821.41,1025.75,0.0,1847.16,196123.51
206,2040-12-02,196123.51,1847.15,825.67,1021.48,0.0,1847.15,195297.84
207,2041-01-01,195297.84,1847.15,829.97,1017.18,0.0,1847.15,194467.87
208,2041-01-31,194467.87,1847.16,834.31,1012.85,0.0,1847.16,193633.56
209,2041-03-02,193633.56,1847.16,838.65,1008.51,0.0,1847.16,192794.91
210,2041-04-01,192794.91,1847.15,843.01,1004.14,0.0,1847.15,191951.9
211,2041-05-01,191951.9,1847.16,847.41,999.75,0.0,1847.16,191104.49
212,2041-05-31,191104.49,1847.15,851.81,995.34,0.0,1847.15,190252.68
213,2041-06-30,190252.68,1847.16,856.26,990.9,0.0,1847.16,189396.42
214,2041-07-30,189396.42,1847.16,860.72,986.44,0.0,1847.16,188535.7
215,2041-08-29,188535.7,1847.15,865.19,981.96,0.0,1847.15,187670.51
216,2041-09-28,187670.51,1847.16,869.71,977.45,0.0,1847.16,186800.8
217,2041-10-28,186800.8,1847.16,874.24,972.92,0.0,1847.16,185926.56
218,2041-11-27,185926.56,1847.15,878.78,968.37,0.0,1847.15,185047.78
219,2041-12-27,185047.78,1847.16,883.37,963.79,0.0,1847.16,184164.41
220,2042-01-26,184164.41,1847.15,887.96,959.19,0.0,1847.15,183276.45
221,2042-02-25,183276.45,1847.16,892.6,954.56,0.0,1847.16,182383.85
222,2042-03-27,182383.85,1847.15,897.23,949.92,0.0,1847.15,181486.62
223,2042-04-26,181486.62,1847.16,901.92,945.24,0.0,1847.16,180584.7
224,2042-05-26,180584.7,1847.15,906.6,940.55,0.0,1847.15,179678.1
225,2042-06-25,179678.1,1847.16,911.34,935.82,0.0,1847.16,178766.76
226,2042-07-25,178766.76,1847.15,916.07,931.08,0.0,1847.15,177850.69
227,2042-08-24,177850.69,1847.16,920.85,926.31,0.0,1847.16,176929.84
228,2042-09-23,176929.84,1847.16,925.65,921.51,0.0,1847.16,176004.19
229,2042-10-23,176004.19,1847.15,930.46,916.69,0.0,1847.15,175073.73
230,2042-11-22,175073.73,1847.16,935.32,911.84,0.0,1847.16,174138.41
231,2042-12-22,174138.41,1847.15,940.18,906.97,0.0,1847.15,173198.23
232,2043-01-21,173198.23,1847.16,945.09,902.07,0.0,1847.16,172253.14
233,2043-02-20,172253.14,1847.15,950.0,897.15,0.0,1847.15,171303.14
234,2043-03-22,171303.14,1847.15,954.95,892.2,0.0,1847.15,170348.19
235,2043-04-21,170348.19,1847.15,959.92,887.23,0.0,1847.15,169388.27
236,2043-05-21,169388.27,1847.16,964.93,882.23,0.0,1847.16,168423.34
237,2043-06-20,168423.34,1847.15,969.95,877.2,0.0,1847.15,167453.39
238,2043-07-20,167453.39,1847.15,975.0,872.15,0.0,1847.15,166478.39
239,2043-08-19,166478.39,1847.15,980.08,867.07,0.0,1847.15,165498.31
240,2043-09-18,165498.31,1847.15,985.18,861.97,0.0,1847.15,164513.13
241,2043-10-18,164513.13,1847.16,990.32,856.84,0.0,1847.16,163522.81
242,2043-11-17,163522.81,1847.15,995.47,851.68,0.0,1847.15,162527.34
243,2043-12-17,162527.34,1847.16,1000.66,846.5,0.0,1847.16,161526.68
244,2044-01-16,161526.68,1847.15,1005.87,841.28,0.0,1847.15,160520.81
245,2044-02-15,160520.81,1847.15,1011.1,836.05,0.0,1847.15,159509.71
246,2044-03-16,159509.71,1847.16,1016.38,830.78,0.0,1847.16,158493.33
247,2044-04-15,158493.33,1847.16,1021.67,825.49,0.0,1847.16,157471.66
248,2044-05-15,157471.66,1847.16,1027.0,820.16,0.0,1847.16,156444.66
249,2044-06-14,156444.66,1847.15,1032.33,814.82,0.0,1847.15,155412.33
250,2044-07-14,155412.33,1847.16,1037.72,809.44,0.0,1847.16,154374.61
251,2044-08-13,154374.61,1847.15,1043.12,804.03,0.0,1847.15,153331.49
252,2044-09-12,153331.49,1847.15,1048.55,798.6,0.0,1847.15,152282.94
253,2044-10-12,152282.94,1847.16,1054.02,793.14,0.0,1847.16,151228.92
254,2044-11-11,151228.92,1847.15,1059.5,787.65,0.0,1847.15,150169.42
255,2044-12-11,150169.42,1847.16,1065.03,782.13,0.0,1847.16,149104.39
256,2045-01-10,149104.39,1847.15,1070.56,776.59,0.0,1847.15,148033.83
257,2045-02-09,148033.83,1847.16,1076.15,771.01,0.0,1847.16,146957.68
258,2045-03-11,146957.68,1847.15,1081.75,765.4,0.0,1847.15,145875.93
259,2045-04-10,145875.93,1847.15,1087.38,759.77,0.0,1847.15,144788.55
260,2045-05-10,144788.55,1847.16,1093.05,754.11,0.0,1847.16,143695.5
261,2045-06-09,143695.5,1847.16,1098.75,748.41,0.0,1847.16,142596.75
262,2045-07-09,142596.75,1847.15,1104.46,742.69,0.0,1847.15,141492.29
263,2045-08-08,141492.29,1847.15,1110.21,736.94,0.0,1847.15,140382.08
264,2045-09-07,140382.08,1847.16,1116.0,731.16,0.0,1847.16,139266.08
265,2045-10-07,139266.08,1847.16,1121.82,725.34,0.0,1847.16,138144.26
266,2045-11-06,138144.26,1847.15,1127.65,719.5,0.0,1847.15,137016.61
267,2045-12-06,137016.61,1847.15,1133.52,713.63,0.0,1847.15,135883.09
268,2046-01-05,135883.09,1847.16,1139.44,707.72,0.0,1847.16,134743.65
269,2046-02-04,134743.65,1847.15,1145.36,701.79,0.0,1847.15,133598.29
270,2046-03-06,133598.29,1847.15,1151.33,695.82,0.0,1847.15,132446.96
271,2046-04-05,132446.96,1847.15,1157.32,689.83,0.0,1847.15,131289.64
272,2046-05-05,131289.64,1847.16,1163.36,683.8,0.0,1847.16,130126.28
273,2046-06-04,130126.28,1847.15,1169.41,677.74,0.0,1847.15,128956.87
274,2046-07-04,128956.87,1847.16,1175.51,671.65,0.0,1847.16,127781.36
275,2046-08-03,127781.36,1847.15,1181.62,665.53,0.0,1847.15,126599.74
276,2046-09-02,126599.74,1847.16,1187.79,659.37,0.0,1847.16,125411.95
277,2046-10-02,125411.95,1847.15,1193.96,653.19,0.0,1847.15,124217.99
278,2046-11-01,124217.99,1847.16,1200.19,646.97,0.0,1847.16,123017.8
279,2046-12-01,123017.8,1847.16,1206.44,640.72,0.0,1847.16,121811.36
280,2046-12-31,121811.36,1847.15,1212.72,634.43,0.0,1847.15,120598.64
281,2047-01-30,120598.64,1847.15,1219.03,628.12,0.0,1847.15,119379.61
282,2047-03-01,119379.61,1847.16,1225.39,621.77,0.0,1847.16,118154.22
283,2047-03-31,118154.22,1847.16,1231.77,615.39,0.0,1847.16,116922.45
284,2047-04-30,116922.45,1847.16,1238.19,608.97,0.0,1847.16,115684.26
285,2047-05-30,115684.26,1847.15,1244.63,602.52,0.0,1847.15,114439.63
286,2047-06-29,114439.63,1847.15,1251.11,596.04,0.0,1847.15,113188.52
287,2047-07-29,113188.52,1847.16,1257.64,589.52,0.0,1847.16,111930.88
288,2047-08-28,111930.88,1847.15,1264.18,582.97,0.0,1847.15,110666.7
289,2047-09-27,110666.7,1847.15,1270.76,576.39,0.0,1847.15,109395.94
290,2047-10-27,109395.94,1847.16,1277.39,569.77,0.0,1847.16,108118.55
291,2047-11-26,108118.55,1847.15,1284.03,563.12,0.0,1847.15,106834.52
292,2047-12-26,106834.52,1847.16,1290.73,556.43,0.0,1847.16,105543.79
293,2048-01-25,105543.79,1847.15,1297.44,549.71,0.0,1847.15,104246.35
294,2048-02-24,104246.35,1847.16,1304.21,542.95,0.0,1847.16,102942.14
295,2048-03-25,102942.14,1847.16,1311.0,536.16,0.0,1847.16,101631.14
296,2048-04-24,101631.14,1847.16,1317.83,529.33,0.0,1847.16,100313.31
297,2048-05-24,100313.31,1847.15,1324.68,522.47,0.0,1847.15,98988.63
298,2048-06-23,98988.63,1847.16,1331.59,515.57,0.0,1847.16,97657.04
299,2048-07-23,97657.04,1847.16,1338.53,508.63,0.0,1847.16,96318.51
300,2048-08-22,96318.51,1847.16,1345.5,501.66,0.0,1847.16,94973.01
301,2048-09-21,94973.01,1847.15,1352.5,494.65,0.0,1847.15,93620.51
302,2048-10-21,93620.51,1847.16,1359.55,487.61,0.0,1847.16,92260.96
303,2048-11-20,92260.96,1847.15,1366.62,480.53,0.0,1847.15,90894.34
304,2048-12-20,90894.34,1847.16,1373.75,473.41,0.0,1847.16,89520.59
305,2049-01-19,89520.59,1847.16,1380.91,466.25,0.0,1847.16,88139.68
306,2049-02-18,88139.68,1847.15,1388.09,459.06,0.0,1847.15,86751.59
307,2049-03-20,86751.59,1847.16,1395.33,451.83,0.0,1847.16,85356.26
308,2049-04-19,85356.26,1847.15,1402.59,444.56,0.0,1847.15,83953.67
309,2049-05-19,83953.67,1847.15,1409.89,437.26,0.0,1847.15,82543.78
310,2049-06-18,82543.78,1847.16,1417.24,429.92,0.0,1847.16,81126.54
311,2049-07-18,81126.54,1847.16,1424.63,422.53,0.0,1847.16,79701.91
312,2049-08-17,79701.91,1847.15,1432.04,415.11,0.0,1847.15,78269.87
313,2049-09-16,78269.87,1847.15,1439.49,407.66,0.0,1847.15,76830.38
314,2049-10-16,76830.38,1847.16,1447.0,400.16,0.0,1847.16,75383.38
315,2049-11-15,75383.38,1847.15,1454.53,392.62,0.0,1847.15,73928.85
316,2049-12-15,73928.85,1847.16,1462.11,385.05,0.0,1847.16,72466.74
317,2050-01-14,72466.74,1847.16,1469.73,377.43,0.0,1847.16,70997.01
318,2050-02-13,70997.01,1847.15,1477.37,369.78,0.0,1847.15,69519.64
319,2050-03-15,69519.64,1847.16,1485.08,362.08,0.0,1847.16,68034.56
320,2050-04-14,68034.56,1847.15,1492.8,354.35,0.0,1847.15,66541.76
321,2050-05-14,66541.76,1847.16,1500.59,346.57,0.0,1847.16,65041.17
322,2050-06-13,65041.17,1847.15,1508.39,338.76,0.0,1847.15,63532.78
323,2050-07-13,63532.78,1847.16,1516.26,330.9,0.0,1847.16,62016.52
324,2050-08-12,62016.52,1847.16,1524.16,323.0,0.0,1847.16,60492.36
325,2050-09-11,60492.36,1847.15,1532.09,315.06,0.0,1847.15,58960.27
326,2050-10-11,58960.27,1847.15,1540.07,307.08,0.0,1847.15,57420.2
327,2050-11-10,57420.2,1847.15,1548.09,299.06,0.0,1847.15,55872.11
328,2050-12-10,55872.11,1847.15,1556.15,291.0,0.0,1847.15,54315.96
329,2051-01-09,54315.96,1847.16,1564.26,282.9,0.0,1847.16,52751.7
330,2051-02-08,52751.7,1847.16,1572.41,274.75,0.0,1847.16,51179.29
331,2051-03-10,51179.29,1847.15,1580.59,266.56,0.0,1847.15,49598.7
332,2051-04-09,49598.7,1847.16,1588.83,258.33,0.0,1847.16,48009.87
333,2051-05-09,48009.87,1847.16,1597.11,250.05,0.0,1847.16,46412.76
334,2051-06-08,46412.76,1847.15,1605.42,241.73,0.0,1847.15,44807.34
335,2051-07-08,44807.34,1847.15,1613.78,233.37,0.0,1847.15,43193.56
336,2051-08-07,43193.56,1847.16,1622.19,224.97,0.0,1847.16,41571.37
337,2051-09-06,41571.37,1847.16,1630.64,216.52,0.0,1847.16,39940.73
338,2051-10-06,39940.73,1847.15,1639.13,208.02,0.0,1847.15,38301.6
339,2051-11-05,38301.6,1847.15,1647.66,199.49,0.0,1847.15,36653.94
340,2051-12-05,36653.94,1847.16,1656.25,190.91,0.0,1847.16,34997.69
341,2052-01-04,34997.69,1847.16,1664.88,182.28,0.0,1847.16,33332.81
342,2052-02-03,33332.81,1847.16,1673.55,173.61,0.0,1847.16,31659.26
343,2052-03-04,31659.26,1847.15,1682.26,164.89,0.0,1847.15,29977.0
344,2052-04-03,29977.0,1847.15,1691.02,156.13,0.0,1847.15,28285.98
345,2052-05-03,28285.98,1847.16,1699.84,147.32,0.0,1847.16,26586.14
346,2052-06-02,26586.14,1847.15,1708.68,138.47,0.0,1847.15,24877.46
347,2052-07-02,24877.46,1847.16,1717.59,129.57,0.0,1847.16,23159.87
348,2052-08-01,23159.87,1847.15,1726.53,120.62,0.0,1847.15,21433.34
349,2052-08-31,21433.34,1847.15,1735.52,111.63,0.0,1847.15,19697.82
350,2052-09-30,19697.82,1847.16,1744.57,102.59,0.0,1847.16,17953.25
351,2052-10-30,17953.25,1847.15,1753.64,93.51,0.0,1847.15,16199.61
352,2052-11-29,16199.61,1847.16,1762.79,84.37,0.0,1847.16,14436.82
353,2052-12-29,14436.82,1847.15,1771.96,75.19,0.0,1847.15,12664.86
354,2053-01-28,12664.86,1847.15,1781.19,65.96,0.0,1847.15,10883.67
355,2053-02-27,10883.67,1847.15,1790.46,56.69,0.0,1847.15,9093.21
356,2053-03-29,9093.21,1847.16,1799.8,47.36,0.0,1847.16,7293.41
357,2053-04-28,7293.41,1847.16,1809.17,37.99,0.0,1847.16,5484.24
358,2053-05-28,5484.24,1847.16,1818.6,28.56,0.0,1847.16,3665.64
359,2053-06-27,3665.64,1847.15,1828.06,19.09,0.0,1847.15,1837.58
360,2053-07-27,1837.58,1847.15,1837.58,9.57,0.0,1847.15,0.0
